1111111111111111111
1P0000C0010000000C1
1000C00000001000001
1110000000111111111
1000001100000100001
1010000000000000001
11111110000C0CC0001
10000000000000000C1
1001111111111110111
1000000C00000000001
1111111111111111111