1111111111111111111
100000C0010000000C1
1000C00000001000001
1110000000111111111
1000001100000100001
101000000P000000001
11111110000C0CC0001
100000000E0000000C1
1001111111111110111
1000000C00000000001
1111111111111111111