1111111111111111111
1P0000C0010000000C1
1000C00000001000001
1110000000111111111
1000001100000100001
1111111111111111111